ADC	KEYWORD1
RingBuffer	KEYWORD1
RingBufferDMA	KEYWORD1

ADC_0	LITERAL1
ADC_1	LITERAL1
ADC_VERY_LOW_SPEED	LITERAL1
ADC_LOW_SPEED	LITERAL1
ADC_MED_SPEED	LITERAL1
ADC_HIGH_SPEED_16BITS	LITERAL1
ADC_HIGH_SPEED	LITERAL1
ADC_VERY_HIGH_SPEED	LITERAL1

setReference	KEYWORD2
setResolution	KEYWORD2
getResolution	KEYWORD2
getMaxValue	KEYWORD2
setConversionSpeed	KEYWORD2
setSamplingSpeed	KEYWORD2
setAveraging	KEYWORD2
enableInterrupts	KEYWORD2
disableInterrupts	KEYWORD2
enableDMA	KEYWORD2
disableDMA	KEYWORD2
enableCompare	KEYWORD2
enableCompareRange	KEYWORD2
disableCompare	KEYWORD2
enablePGA	KEYWORD2
getPGA	KEYWORD2
disablePGA	KEYWORD2
isConverting	KEYWORD2
isComplete	KEYWORD2
isDifferential	KEYWORD2
isContinuous	KEYWORD2
analogRead	KEYWORD2
analogReadDifferential	KEYWORD2
startSingleRead	KEYWORD2
startSingleDifferential	KEYWORD2
readSingle	KEYWORD2
startContinuous	KEYWORD2
startContinuousDifferential	KEYWORD2
analogReadContinuous	KEYWORD2
stopContinuous	KEYWORD2
analogSynchronizedRead	KEYWORD2
analogSyncRead	KEYWORD2
analogSynchronizedReadDifferential	KEYWORD2
analogSyncReadDifferential	KEYWORD2
startSynchronizedSingleRead	KEYWORD2
startSynchronizedSingleDifferential	KEYWORD2
readSynchronizedSingle	KEYWORD2
startSynchronizedContinuous	KEYWORD2
startSynchronizedContinuousDifferential	KEYWORD2
readSynchronizedContinuous	KEYWORD2
stopSynchronizedContinuous	KEYWORD2

